111111
1E0001
110C11
101001
1P0011
111111