1111111111111111111111111111111111
1000000000000000000000000000000001
10000C000000000000000000000000C001
1000000000000000000000000000000001
1000000000000000000000000000000001
1000000000000000011111111000000001
1000000000000000000000000000000001
1000000P00000111111000000000000001
1000000000000000000000000000000001
1000000000000000000000000000000001
1000000000000001111111111100000001
10000000000000000000000000C0000001
1000000000000000000000000000000001
1100000111100000000001110000000001
111111000000000000000000011100C001
1111000111111100000000000000000001
1100000000001110000000000000000001
1111100000001110000000000000000001
1000000000000110000000000000000001
1000000000000000110000001111100001
1000000000000000000000000000000001
100000000000000000000C000000000001
1000000111110000000000000000000001
1000000000000000000000000000000001
1000000000000000000001110000000001
1000000000000000000000000000000001
1000000111100000000000000000000001
1000000001C00100000000000000000001
1000000000000000000000000000E00001
1000000000000000000000000000000001
1000000000000000111000000000000001
1000000000000000000000000000000001
1000000000000000000000000000000001
1000000000000000000000000000000001
1111111111111111111111111111111111