11111111
1E111111
10000001
11111101
1P0000C1
11111111