111111111111110
100000000000001
100000000000001
100000000000001
111111111111111