111111111
10P0E0101
100100C01
111111111