1111111111111111111111111111
1P0000000C000000000100000011
10000100000000000001E0000001
1000010000000000000010000001
1000C00000000000000001000001
100000000000110000001C000001
100000000100000C000001000001
1111111111111111111111111111