1111111111111111111111111111
1P01100000C00000000100000001
10000100000000000001E0000001
1000010000001110000000000001
1000C0000000C000000001100001
100110000000110000000C000001
100000000100000C000000000001
1111111111111111111111111111