1111111111111111111111111111
1011100000C00000000100000001
11100100000000000001E0000001
1000010000001110000000000001
1000C0000000C000000001100001
100110000000110000000C000001
100000000100000C0000000P0001
1111111111111111111111111111