1111111111111111111111111111
1P00000000C00000000000000001
10000100000000000000E0000001
1000010000000000000000000001
1000C00000000000000001000001
100000000000110000000C000001
100000000100000C000000000001
1111111111111111111111111111