1111111111111111111111111111
1000000000000000000000000001
100001000000000E000000000001
1000010000000000000000000001
1000000000000000000001000001
1000000000001100000000000001
1000000000000000000000000001
1111111111111111111111111111